00000000000000000
00101000000010100
00000000100000000
01000000000010000
00100000000100000
00001000010000000
00000001000000000
00000000000000000		
00000000000000000
