00000000000
00111011100
00111111100
00011111000
00001110000
00000100000
00000000000
